##########
#2      %#
#  O P   #
#      B #
#G       #
##########