#######
#     #
#P    #
###B  #
###  G#
#######